Parental Unit 9924 (you'd always just called her Nyna) was the sentimental type. Maybe that's why she doted on you most, of all the fledglings in your pod. "Your joining is only is only 3 cycles away," she'd said, and it would mean a great deal to her if you would take the Journey and collect a few things before you came back. It was silly that she insisted on following such an old tradition, but not nearly as silly as measuring time in old Terran solar cycles.

Transhominid
An Interactive Fiction by spanky
Release 1 / Serial number 150826 / Inform 7 build 6L38 (I6/v6.33 lib 6/12N) SD

Lagrange Point
This was where Nyna had said to go, a mining station at the the Sun-Jupiter Lagrange point. The Preserver Collective had done an impressive job with their restoration, though it didn't look like anyone had ever bothered to visit. There was something lonely about the hulking metal structure, an abandoned museum, frozen in eternal stasis.

All the stars look unfamiliar this far from home, and you have to take a moment to reorient yourself to the Milky Way's magnetic north.

To the east, you see a large hangar bay leading to the interior of the station.

>w
Lagrange Point
This was where Nyna had said to go, a mining station at the the Sun-Jupiter Lagrange point. The Preserver Collective had done an impressive job with their restoration, though it didn't look like anyone had ever bothered to visit. There was something lonely about the hulking metal structure, an abandoned museum, frozen in eternal stasis.

All the stars look unfamiliar this far from home, and you have to take a moment to reorient yourself to the Milky Way's magnetic north.

To the east, you see a large hangar bay leading to the interior of the station.

>i
You are carrying:
     Nothing.

You are looking for:
     Object not covered by Intergalactic Cultural Antiquities Convention
     Substance predating the Terran system
     Matter radiating in the 600 TeraHertz range
     Material younger than yourself

* * *

>x rock
It's an asteroid.

>go outside
Lagrange Point
This is where Nyna had said to go, a mining station at the the Sun-Jupiter Lagrange point. The Preserver Collective had done an impressive job with their restoration, though it didn't look like anyone had ever bothered to visit for a tour. There was something lonely about the structure, an abandoned museum forever trapped in stasis. The water in your eyes begins to evaporate in the low pressure of space, producing a curious feeling.

Inside the station is a hangar bay.

>go inside the statin
You can't see any such thing.

>go inside the station
You can't see any such thing.

* * *

>x rock
It's an asteroid.

>l
Hangar Bay
The hangar bay doors are open. Outside, you can see the vacuum of space extending in every direction.

You can see chunk of Terran obsidian here.

>x rock
You see nothing special about chunk of Terran obsidian.

>x
(chunk of Terran obsidian)
You see nothing special about chunk of Terran obsidian.

* * *

>x rock
It's an asteroid.

>ls
That's not a verb I recognise.

>look
Hangar Bay
The hangar bay doors are open. Outside, you can see the vacuum of space extending in every direction.

You can see a Terran obsidian rock here.

>take rock
Taken.

>look
Hangar Bay
The hangar bay doors are open. Outside, you can see the vacuum of space extending in every direction.

>i
You are carrying:
  a Terran obsidian rock

* * *

>x rock
It's an asteroid.

>look
Hangar Bay
The hangar bay doors are open. Outside, you can see the vacuum of space extending in every direction. (he->be reaction FIXME

You can see a chunk of asteroid, solar wind and a submerged emitter here.

>x asteroid
It's an asteroid.

>take asteroid
Woo
Woo
Taken.

>i
You are carrying:
     chunk of asteroid

You are looking for:
     Object not covered by Intergalactic Cultural Antiquities Convention
     Matter radiating in the 600 TeraHertz range
     Material younger than yourself

>x solar wind
Particles in a superheated plasma expelled by the dying star of the Sol system.

>look
Hangar Bay
The hangar bay doors are open. Outside, you can see the vacuum of space extending in every direction. (he->be reaction FIXME

You can see free hydrogen and a submerged emitter here.

>take free hydrogen
Taken.

>undo
Hangar Bay
[Previous turn undone.]

>take hydrogen
Taken.

>look
Hangar Bay
The hangar bay doors are open. Outside, you can see the vacuum of space extending in every direction. (he->be reaction FIXME

You can see a submerged emitter here.

>i
You are carrying:
     chunk of asteroid

You are looking for:
     Object not covered by Intergalactic Cultural Antiquities Convention
     Matter radiating in the 600 TeraHertz range

>look
Hangar Bay
The hangar bay doors are open. Outside, you can see the vacuum of space extending in every direction. (he->be reaction FIXME

You can see a submerged emitter here.

* * *

>look
Hangar Bay
The hangar bay doors are open. Outside, you can see the vacuum of space extending in every direction. (he->be reaction FIXME

You can see a chunk of asteroid, solar wind and a submerged emitter here.

>take rock
You can't see any such thing.

>take chunk
Woo
Woo
Taken.

>look
Hangar Bay
The hangar bay doors are open. Outside, you can see the vacuum of space extending in every direction. (he->be reaction FIXME

You can see solar wind and a submerged emitter here.

>i
You are carrying:
     chunk of asteroid

You are looking for:
     Object radiating in the 600 TeraHertz range

>drop rock
You can't see any such thing.

>drop chunk
Woo
Woo
Dropped.

>i
You are carrying:
     Nothing.

You are looking for:
     A relic
     Object radiating in the 600 TeraHertz range

>look
Hangar Bay
The hangar bay doors are open. Outside, you can see the vacuum of space extending in every direction. (he->be reaction FIXME

You can see a chunk of asteroid, solar wind and a submerged emitter here.

>look
Hangar Bay
The hangar bay doors are open. Outside, you can see the vacuum of space extending in every direction.

You can see Terran obsidian here.

>take terran
Taken.

>drop terran
Dropped.

>take rock
Taken.

>drop terran
Dropped.

>i
You are carrying nothing.

>take terran
Taken.

>i
You are carrying:
  Terran obsidian

>x terran
You see nothing special about Terran obsidian.

* * *

>take roc
You can't see any such thing.

>take rock
Taken.

>i
You are carrying:
     rock

You are looking for:
     Object reflecting light in the 450-490 nm range

>i
You are carrying:
     rock

You are looking for:
     Object reflecting light in the 450-490 nm range

>take solar
Taken.

>i
You are carrying:
     rock

You are looking for:
     Object reflecting light in the 450-490 nm range

>look
Hangar Bay
The hangar bay doors are open. Outside, you can see the vacuum of space extending in every direction. (he->be reaction FIXME

You can see a Cherenkov emitter here.

>drop something
(the rock)
Dropped.

>drop something
Which do you mean, the rock or the Cherenkov emitter?

>i
You are carrying:

You are looking for:
     A relic
     Object reflecting light in the 450-490 nm range

>drop solar
Dropped.

>i
You are carrying:
     Nothing.

You are looking for:
     A relic
     Object reflecting light in the 450-490 nm range

>take solar
Taken.

>i
You are carrying:

You are looking for:
     A relic
     Object reflecting light in the 450-490 nm range

* * *

>i
You are carrying:
     rock

You are looking for:
     Object reflecting light in the 450-490 nm range

>x rock
A smooth, shiny piece of rock that glitters in the starlight.

>look
Hangar Bay
The hangar bay doors are open. Outside, you can see the vacuum of space extending in every direction.

>i
You are carrying:
  chunk of Terran obsidian

>x chunk
A smooth, shiny piece of rock that glitters in the starlight.

>x chunk
A smooth, shiny piece of rock that glitters in the starlight.

* * *

>take a rock
Taken.

>i
You are carrying:
  a rock

>x rock
It's a chunk of Terran obsidian.

>i
You are carrying:
  a rock

>x a rock
You see nothing special about a rock.

>x rock
You see nothing special about Terran obsidian.

>i
You are carrying:
  Terran obsidian

* * *

>i
You are carrying:
     Nothing.

You are looking for:
     A relic
     Object radiating in the 600 TeraHertz range

* * *

>x solar
Particles in a superheated plasma expelled by the dying star of the Sol system.

>look
Hangar Bay
The hangar bay doors are open. Outside, you can see the vacuum of space extending in every direction.

You can see free hydrogen here.

>take free
Taken.

>drop free
Dropped.

>take hydrogen
Taken.

>i
You are carrying:
  free hydrogen

>drop hyd
You can't see any such thing.

>drop hydrog
You can't see any such thing.

>drop hydrogen
Dropped.

>i
You are carrying nothing.

* * *

>x solar wind
Particles in a superheated plasma expelled by the dying star of the Sol system.

>look
Hangar Bay
The hangar bay doors are open. Outside, you can see the vacuum of space extending in every direction. (he->be reaction FIXME

You can see a rock, free hydrogen and a submerged emitter here.

* * *

>out
Sun-Jupiter Lagrange Point 5
Inside the station is a hangar bay.

>enter
You must supply a noun.

>enter station
You can't see any such thing.

>enter door
You can't see any such thing.

>go inside
Hangar Bay
The hangar bay doors are open. Outside, you can see the vacuum of space extending in every direction.

You can see solar wind here.

>exit
Sun-Jupiter Lagrange Point 5
Inside the station is a hangar bay.

* * *

>e
Hangar Bay
The hangar bay doors are open to the west. Outside, you can see the vacuum of space extending in every direction.

You can see a rock, solar wind and a submerged emitter here.

>w
You can't go that way.

>n
You can't go that way.

* * *

>e
Hangar Bay
The hangar bay doors are open to the west. Outside, you can see the vacuum of space extending in every direction.

You can see a rock, solar wind and a submerged emitter here.

>take rock
Renaming something borrowed
Taken.

>i
You are carrying:
     rock

You are looking for:
     Artifact not covered by Intergalactic Cultural Antiquities Convention
     Object radiating in the 600 TeraHertz range
     Material younger than yourself

>x rock
A chunk broken from one of the many asteroids clustered around the Sun-Jupiter L5 point. This one is much older than the solar system itself, having formed light-years away in some distant stellar explosion over five billion years ago. It flew through the vast expanses of space between star systems and came to rest here, trapped for hundreds of thousands of years in the gravity well.

Maybe I can finally take it home.

>take wind
Renaming something borrowed
Taken.

>i
You are carrying:
     presolar grain
     free hydrogen

You are looking for:
     Artifact not covered by Intergalactic Cultural Antiquities Convention
     Object radiating in the 600 TeraHertz range